R 1920 1080 // screen size, -1 (-, 0 막아야 겠네)
NO ./path_to_the_north_texture
SO ./path_to_the_south_texture
WE ./path_to_the_west_texture // 몇개 이상 들어오면 에러
EA ./path_to_the_east_texture

S ./path_to_the_sprite_texture // open error
R 1920 1080
F 200,100,100 // 터지고
C

// 할거고
        1111111111111111111111111
        1000000000110000000000001
        1011000001110000000000001
        1001000000000000000000001
111111111011000001110000000000001
100010000011000001110111111111111
11110111111111011100000010201
11110111111111011101010010001
110000001101010111000000100011111111
10002000000000001100000010001
10000000000000001101010011001
11000001110101011111011110N0111
11110111 1110101 101111010001
11111111 1111111 111111111111
