R 1920 1080
NO ./textures/wall_n.xpm
SO ./textures/wall_s.xpm
WE ./textures/wall_w.xpm
EA ./textures/wall_e.xpm

S ./textures/barrel.xpm

F 110,153,15
C 255,255,255

111111111111111111111111111111111
10000020020000001100000000000001
10000000000000001110020000000001
1000000000000000020000020000011
10000000E000000000002000000000011
100000000011000001110111111111111
11110111111111011100000010001
11110111111111011101010010001
110000001101010111000000100011111111
10000000000000001100000011001
10000000200000001101010011001
10000011101010111110111100111
11110111 1110101 101111010001
11111111 1111111 111111111111
