R 1920 1080
NO ./textures/wall_n.xpm
SO ./textures/wall_s.xpm
WE ./textures/wall_w.xpm
EA ./textures/wall_e.xpm

S ./textures/wall_s.xpm

F 184,113,39
C 51,198,227


111111111111111111111111111111111
100000000000000000110000000000001
10000E000001000001110000000000001
100000000001000000000000000000001
111111111011000001110000000000001
100010000011000001110111111111111
11110111111111011100000010001
11110111111111011101010010001
110000001101010111000000100011111111
10000000000000001100000011001
10000000000000001101010011001
110000011101010111110111100111
11110111 1110101 101111010001
11111111 1111111 111111111111
